NO ./path_to_the_north_texture.xpm

SO ./path_to_the_south_texture.xpm

WE ./path_to_the_west_texture.xpm

EA ./path_to_the_east_texture.xpm

F 92,64,51

C 0,150,255



        11111111111 1111111 1111111
        1000000000110000000100001
        1011000001110000000000001
        1001000000000000000000001
111111111011000001110000000000001
100000000011000001110111111111111
111101111111110111000000000001111
11110111111111011101010010001
11000000110101011100000010001
10000N00000000001100000010001
10000000000000001010100000011
11000001110101011111011110011
11110111 11101011101111010001
11111111 1111111 11111111111
