NO ./maps/textures/north.xpm

SO ./maps/textures/south.xpm

WE ./maps/textures/west.xpm

EA ./maps/textures/east.xpm

C 35,19,73
F 15,6,40

111111111111111
111111000111111
111110000011111
1111000N0001111
111000000000111
1100000000000111111111111111111111111
10000111110000000000000000000000000001
1100001110000111111111111111111111111
111000010000111
111100000001111
111110000011111
111111000111111
111111111111111
