NO ./maps/textures/north.xpm

SO ./maps/textures/south.xpm

WE ./maps/textures/west.xpm

EA ./maps/textures/east.xpm

F 92,64,51

C 30,150,254

11111111111111111
1000S0011000000011111111111111111111111111111111111111111111111
100000000000000000000000000000000000000000000000000000011111111
111111111111111111111111111111111111111111111111111111111111111