C            225,30,0
F              220,100,0
NO           ./path_to_the_north_texture


     SO          ./path_to_the_south_texture
              WE           ./path_to_the_west_texture


           EA           ./path_to_the_east_texture

1111111111111111111111111
1011000000110000000000001
1001000000000000000000001
1000000111111111111000001
11111111          1111001
10000001          1101111
11110111          1000001
11110111          1010001
1100000111111111111000001
1000000000000000110000001
10000000000N0001101010011
1000001110101011111011111
1111011101110101010111101
1111111111111111111111111
